div - универсальный блочный элемент преднохначенный для группировки
span - строчный элемент  преднозначен для выделения отдельных строк, символов
header - задает шапку сайта или раздела
footer - задает подвал сайта или раздела
menu - преднозначен для оборажения списа меню(внутри контейнер формируетс спомощью ul)
article - задает содержимое сайта вроде новости, статьи, записи блога
nav - задает навигацию по сайту (внутри ссылки a) левое меню
aside - раздел страницы, который имеет косвенное отношение к содержимому страницы(рекламный блок, боковая панель) правое меню
section - задает раздел документа(содержит заголовок)

text-align-last - выключка по центру
color- цвет текста
font-family - задает выбранный текст ариал, times new roman
font-size размер текста
font-style - курсив или нет
font-variant - утановить текст заглавными буквами
font-weight - установка жирного текста или насыщенности текста

line-height -межстрочный интервал
hover - псевдокласс(изменяющий слили пра наведении)
&shy - мягкий перенос

text-align - выравнивание текста по выбраному краю(внутри элемета)
float - выравнивает в выбранную сторону весь элемент
text-decoration - украшеие текста(подчеркивание, зачеркивание)
text-indent - создание красной строки внутри элемента(отступ от первой строки)
tex-shadow - тени
text-transform - делает все заглавными буквами, только первую, все строчными

litter-spasing - расстояние между буквами
word-spasing - расстояние между словами

q- заключить в ковычки
cite - цитата
blockquote - цитата в несколько строк

white-space - обреза текста
text-overflow - обрыв текста в блоке

first-line -сфойство первой строки
first-letter - первая буква


Псевдоэлементы
hover - при наведении(для всех лементов) 
visited - посещенная 
link - непосещенные сслыки(для ссылок)
focus - для текстовый полей фокусировка
placeholder-shown - подсказка при наведении
active - нажатая но еще не отпущеная кнопка
nth-child() - позволяет выбрать элемент, even четные элементы, odd нечетные
nth-of-type() - 
only-of-type() - распостраняется на единственного их родителей

border-collaps - если нету отступов между элементами в таблице

padding - внутренний отступ
margin - внешний отступ

vertical-align - расположение во перткали текста




